1 13 31
###############################
#p     s* *  1 * 2 *  * * *   #
# # # #*# # #*#*# # # #*#*#*# #
#   *     b**  *  1   * 2 * * #
# # # #b# #*# # #*#*# # # # #*#
#f    1    x **  *  *   1     #
# # # # # # # # # #*# #*# # # #
#* 1*      *  *      *        #
# # # # #*# # # #*#*# # # # # #
#*    **  *    3  *           #
# #*# # # # # # #*# # # # # # #
#           *   *  *          #
###############################