2 13 31
###############################
#p * *2    b  *  ** * *   1  *#
# # # # #*# # #*# # # # # #*# #
#   f* * *** **  1   *    **  #
# #*# # # # #1# #b#1# # # # #*#
#    1     *     **      *  **#
# # #*# # # # # #*#*#*#*# # # #
#   *   1   s*   * *x* *      #
# # # # #*# # # # # # #*# #*# #
#x  ****         *1           #
# # # # # # # # # #*# # # # #*#
#  ** *   *    3          1   #
###############################