3 13 31
###############################
#p   **       1  f* 2        *#
# # # # # # # # # #*#*# # # #3#
# *        * *  *  *          #
#*#*# # # # #2# # # # # # # #*#
#  x            1    *        #
#*# # # # # # # # # #*# #*# # #
# * ** b    s           *     #
# #*#*#*#*# # #*#*# #*# # # # #
#     ***     **    *   *     #
# # # #*#*#*#*#*# # #*# # # # #
# *       ******* **1         #
###############################